 , ,M, ,S
 , , , ,S
 ,I,S, ,S
 ,S, , ,S
S,S,S,S,S