 , , , ,S
 , , , ,S
 , , ,B,S
I, , , ,S
S,S,S,S,S