#, ,#,#,#,#,#,#,#,#,#,#,#,#,#,#,#,#,#,#,#
#, , , , , ,#, , , , , ,#, , , , , , , ,#
#, ,#,#,#, ,#, ,#,#,#, ,#, ,#,#,#,#,#, ,#
#, ,#, , , ,#, , , ,#, , , ,#, ,#, , , ,#
#, ,#,#,#,#,#,#,#, ,#,#,#, ,#, ,#, ,#,#,#
#, , , ,#, , , ,#, , , ,#, , , ,#, ,#, ,#
#,#,#, ,#, ,#,#,#, , , ,#,#,#,#,#, ,#, ,#
#, , , , , ,#, , , ,#, , , ,#, , , , , ,#
#, ,#,#,#,#,#, ,#, ,#,#,#,#,#, ,#,#,#,#,#
#, , , , , , , ,#, , , ,#, , , , , , , ,#
#,#,#,#,#,#,#,#,#,#,#,#,#,#,#,#,#,#,#,E,#