#,#,#,#,#,#,#,#,#
#, ,#, , , , , ,#
#, ,#, ,#,#,#, ,#
#, ,#, ,#,J,#, ,#
#, ,#, ,#, ,#, ,#
#, ,#, ,#, ,#, ,#
#, ,#, , , ,#, ,#
#, ,#,#,#,#,#, ,#
#, , , , , , , ,#
#,#,#,#,#,#,#,#,#