#,#,#,#,#,#,#,#,#,#,#,#,#
#, ,#, , , , , , , , , ,#
#, ,#, ,#,#,#,#,#,#,#, ,#
#, ,#, ,#, , , , , ,#, ,#
#, ,#, ,#, ,#,#,#, ,#, ,#
#, ,#, ,#, ,#,J,#, ,#, ,#
#, ,#, ,#, ,#, ,#, ,#, ,#
#, ,#, ,#, , , ,#, ,#, ,#
#, ,#, ,#,#,#,#,#, ,#, ,#
#, ,#, , , , , , , ,#, ,#
#, ,#,#,#,#,#,#,#,#,#, ,#
#, , , , , , , , , , , ,#
#,#,#,#,#,#,#,#,#,#,#,#,#