#,#,#,#,#,#,#,#,#,#,#,#,#
#, , , , , , , , , , , ,#
#,#,#,#,#,#,#,#,#,#,#, ,#
#, , , , , , , , , , , ,#
#, ,#,#,#,#,#,#,#,#,#,#,#
#, , , , , , , , , , , ,#
#,#,#,#,#,#,#,#,#,#,#, ,#
#, , , , , , , , , , , ,#
#, ,#,#,#,#,#,#,#,#,#,#,#
#, , , , , , , , , , , ,#
#,#,#,#,#,#,#,#,#,#,#, ,#
#,I, , , , , , , , , , ,#
#,#,#,#,#,#,#,#,#,#,#,#,#