#,#,#,#,#,#,#,#,#,#,#,#,#,#,#,#,#
#,#,#,#,#,#,#,#,#,#,#,#,#,#,#,#,#
#,#,#,#,#,#,#,#,#,#,#,#,#, , ,O,M
#,#,#,#,#,#,#,#,#,#,#,#, , ,#,#,#
#,#,#,#,#,#,#,#,#,#,#, , ,#,#,#,#
#,#,#,#,#,#,#,#,#,#, , ,#,#,#,#,#
#,#,#,#,#,#,#,#,#, , ,#,#,#,#,#,#
#,#,#,#,#,#,#,#, , ,#,#,#,#,#,#,#
#,#,#,#,#,#,#, , ,#,#,#,#,#,#,#,#
#,#,#,#,#,#, , ,#,#,#,#,#,#,#,#,#
#,#,#,#,#, , ,#,#,#,#,#,#,#,#,#,#
#,#,#,#, , ,#,#,#,#,#,#,#,#,#,#,#
#,#,#, , ,#,#,#,#,#,#,#,#,#,#,#,#
#,#, , ,#,#,#,#,#,#,#,#,#,#,#,#,#
#, , ,#,#,#,#,#,#,#,#,#,#,#,#,#,#
 , ,#,#,#,#,#,#,#,#,#,#,#,#,#,#,#
 ,#,#,#,#,#,#,#,#,#,#,#,#,#,#,#,#
#,#,#,#,#,#,#,#,#,#,#,#,#,#,#,#,#