#,#,#,#,#,#,#,#,#,#,#,#,#
#,B, , , ,#, , , , , , ,#
#,#,#, ,#,#, , , , , , ,#
#, ,#, ,#, , , , , , , ,#
#, ,#, ,#, , , , , , , ,#
#, ,#, ,#, , , , , , , ,#
#, ,#, ,#, , , , , , , ,#
#, ,#, ,#,#,#,#, ,#,#,#,#
#, , , , , , , , , , , ,#
#,#,#,#,#, ,#,#,#,#,#,#,#
