#,#,#,#,#,#,#,#,#,#,#,#,#
#,B, , , ,#, , , , , , ,#
#,#,#, ,#,#, , , , , , ,#
#, ,#, ,#, , , , , , , ,#
#, ,#, ,#, , , , , , , ,#
#, ,#, ,#, , , , , , , ,#
#, ,#, ,#, , , , , , , ,#
#, ,#, ,#,#,#,#, ,#,#,#,#
#, , , , , , , , , , ,T,#
#,#,#,#,#, ,#,#,#,#,#,#,#
