#,#,#,#,#,#,#,#,#,#,#,#,#,#,#,#,#,#,#,#,#,#,#,#,#,#,#
#,#,#,#,#,#,#,#,#,#,#,#,#,#,#,#,#,#,#,#,#,#,#,#,#,#,#
#,#,#,#,#, , , ,#,#,#,#,#,#,#,#,#,#,#,#, , , ,#,#,#,#
#,#,#, , , , , , ,#,#,#,#,#,#,#,#,#, , , , , , ,#,#,#
#,#, , , , , , , , ,#,#,#,#,#,#,#, , , , , , , , ,#,#
#, , , , ,#,#,#,#, , ,#,#,#,#,#, , ,#,#,#,#, , , ,#,#
#, , , ,#,#,#,#,#,#, , ,#,#,#, , ,#,#,#,#,#,#, , , ,#
#, , ,#,#,#,#,#,#,#,#, , , , , ,#,#,#,#,#,#,#,#, , ,#
 , , ,#,#,#,#,#,#,#,#,#,#, ,#,#,#,#,#,#,#,#,#,#, , ,#
 , , ,#,#,#,#,#,#,#,#, , , , , ,#,#,#,#,#,#,#,#, , ,#
#, , , ,#,#,#,#,#,#, , ,#,#,#, , ,#,#,#,#,#,#, , , ,#
#,#, , , ,#,#,#,#, , ,#,#,#,#,#, , ,#,#,#,#, , , , ,#
#,#,#, , , , , , , ,#,#,#,#,#,#,#, , , , , , , , ,#,#
#,#,#,#, , , , , ,#,#,#,#,#,#,#,#,#, , , , , , ,#,#,#
#,#,#,#,#, , , ,#,#,#,#,#,#,#,#,#,#,#, , , , ,#,#,#,#
#,#,#,#,#,#,#,#,#,#,#,#,#,#,#,#,#,#,#,#,#,#,#,#,#,#,#
#,#,#,#,#,#,#,#,#,#,#,#,#,#,#,#,#,#,#,#,#,#,#,#,#,#,#
#,#,#,#,#,#,#,#,#,#,#,#,#,#,#,#,#,#,#,#,#,#,#,#,#,#,#

